####################
#                  #
#                  #
#                  #
#                  #
#                  #
#                  #
#########DD#########
