################################################################################################################################################################
#                                                                                                                                                              #
#   @                                                                                                                                                          #
#                                                                                                                                                              #
###########################################################################################################################################################    #
#                                                                                                                                                              #
#                                                                                                                                                              #
#                                                                                                                                                              #
#   ############################################################################################################################################################
#                                                                                                                                                             ##
#                                                                                                                                                              #
#                                                                                                                                                              #
###########################################################################################################################################################    #
#                                                                                                                                                              #
#                                                                                                                                                              #
#                                                                                                                                                              #
#   ############################################################################################################################################################
#                                                                                                                                                            ###
#                                                                                                                                                              #
#                                                                                                                                                              #
###########################################################################################################################################################    #
#                                                                                                                                                              #
#                                                                                                                                                              #
#                                                                                                                                                              #
#   ############################################################################################################################################################
#                                                                                                                                                           ####
#                                                                                                                                                              #
#                                                                                                                                                              #
###########################################################################################################################################################    #
#                                                                                                                                                              #
#                                                                                                                                                              #
#                                                                                                                                                              #
#   ############################################################################################################################################################
#                                                                                                                                                          #####
#                                                                                                                                                              #
#                                                                                                                                                              #
###########################################################################################################################################################    #
#                                                                                                                                                              #
#                                                                                                                                                              #
#                                                                                                                                                              #
#   ############################################################################################################################################################
#                                                                                                                                                         ######
#                                                                                                                                                              #
#                                                                                                                                                              #
###########################################################################################################################################################    #
#                                                                                                                                                              #
#                                                                                                                                                              #
#                                                                                                                                                              #
#   ############################################################################################################################################################
#                                                                                                                                                        #######
#                                                                                                                                                              #
#                                                                                                                                                              #
###########################################################################################################################################################    #
#                                                                                                                                                              #
#                                                                                                                                                              #
#                                                                                                                                                              #
#   ############################################################################################################################################################
#                                                                                                                                                       ########
#                                                                                                                                                          F   #
#                                                                                                                                                              #
################################################################################################################################################################
